25,26,60,28,28,28,28,26,26,26
41,25,26,26,26,26,28,26,26,26
42,41,25,26,26,26,28,26,26,26
41,25,26,26,26,26,28,26,26,26
25,26,26,26,26,26,28,26,26,26
26,26,28,28,28,28,28,26,26,26
26,26,28,26,26,26,26,26,26,25
25,26,44,26,26,26,26,26,25,41
41,26,26,26,26,26,25,41,42,42
42,25,26,25,25,25,41,42,42,46
