0,1,11,3,3,3,3,1,1,1
4,0,1,1,1,1,3,1,1,1
5,4,0,1,1,1,3,1,1,1
4,0,1,1,1,1,3,1,1,1
0,1,1,1,1,1,3,1,1,1
1,1,3,3,3,3,3,1,1,1
1,1,3,1,1,1,1,1,1,0
0,1,7,1,1,1,1,1,0,4
4,1,1,1,1,1,0,4,5,5
5,0,1,0,0,0,4,5,5,6
