13,26,13,12,26,13,12,26,12,26
26,12,26,13,12,26,13,12,13,12
12,26,13,12,13,12,26,13,12,13
26,13,12,26,12,26,13,26,13,12
13,26,13,12,13,12,26,13,12,26
12,13,26,13,12,26,12,26,13,12
13,26,13,12,13,12,13,12,26,13
26,13,26,13,26,13,26,13,12,26
13,26,12,26,13,26,13,12,26,13
12,13,26,13,26,13,12,13,12,26
